20 20
30 70
1 1 1 1 1 1 1 1 1 1 1 1 1 1 1 1 1 1 1 1
1 1 1 1 1 1 1 1 1 1 1 1 1 1 1 1 1 1 1 1
1 21 1 22 1 23 1 24 1 25 1 1 1 1 1 1 1 1 1 1
1 5 1 5 5 1 1 1 1 1 1 1 1 1 1 1 1 1 1 1
1 5 1 1 5 5 5 1 1 1 1 1 1 1 1 1 1 1 1 1
1 5 1 1 1 1 5 1 1 1 1 1 1 1 1 1 1 1 1 1
1 5 1 1 1 1 5 1 1 1 1 1 1 1 1 1 1 1 1 1
1 5 1 1 1 1 5 1 1 1 1 1 1 1 1 1 1 1 1 1
1 5 1 1 1 1 5 1 1 1 1 1 1 1 1 1 1 1 1 1
1 5 1 1 1 1 5 1 1 1 1 1 1 1 1 1 1 1 1 1
1 5 1 1 1 1 5 1 1 1 1 1 1 1 1 1 1 1 1 1
1 5 5 5 5 5 5 1 1 1 1 1 1 1 1 1 1 1 1 1
1 5 1 1 1 1 1 1 1 1 1 1 1 1 1 1 1 1 1 1
1 5 1 1 1 1 1 1 1 1 1 1 1 1 1 1 1 1 1 1
1 5 1 1 1 1 1 1 1 1 1 1 1 1 1 1 1 1 1 1
1 5 1 1 1 1 1 1 1 1 1 1 1 1 1 1 1 1 1 1
1 5 1 1 1 1 1 1 1 1 1 1 1 1 1 1 1 1 1 1
1 5 5 5 1 1 1 1 1 1 1 1 1 1 1 1 1 1 1 1
1 1 1 5 1 1 1 1 1 1 1 1 1 1 1 1 1 1 1 1
1 1 1 1 1 1 1 1 1 1 1 1 1 1 1 1 1 1 1 1