20 20
30 70
1 1 1 1 1 1 1 1 1 1 1 1 1 1 1 1 1 1 1 1 
1 1 1 1 1 1 1 1 1 1 1 1 1 1 1 1 1 1 1 1 
1 21 1 22 1 23 1 24 1 25 1 1 1 1 1 1 1 1 1 1
2 2 2 2 2 2 2 2 2 2 2 2 2 2 2 2 2 2 2 2 
3 6 3 0 1 2 4 4 3 2 6 1 5 3 5 4 0 1 2 6 
6 4 0 6 2 3 5 5 6 2 5 2 1 0 6 4 3 5 3 6 
3 0 3 3 6 4 3 0 6 0 3 5 4 4 0 4 3 3 5 0 
5 5 0 5 1 5 4 5 6 2 1 4 1 4 2 6 0 3 5 2 
0 6 2 2 3 2 0 2 4 2 6 2 4 3 2 3 3 5 2 1 
5 1 6 5 6 6 1 3 5 1 4 4 4 3 4 2 6 0 5 0 
5 6 5 0 5 6 0 6 5 3 0 4 5 1 4 1 2 3 1 1 
1 3 6 2 4 3 1 0 0 3 0 3 5 6 6 1 0 0 5 3 
4 6 5 2 5 1 1 0 6 5 6 0 3 0 4 2 2 0 4 6 
4 1 4 6 5 2 5 4 2 5 5 0 2 0 0 6 5 2 0 5 
1 5 1 4 0 6 1 1 6 0 4 2 3 6 1 3 0 2 2 4 
1 6 0 4 5 0 5 1 5 4 4 3 6 4 5 0 1 0 5 6 
4 1 4 0 2 0 6 0 6 6 4 4 4 5 6 1 6 3 6 6 
4 0 1 2 4 5 1 3 5 0 0 2 5 6 5 3 1 0 0 6 
6 4 2 6 2 2 4 4 0 6 2 3 4 2 4 2 1 0 2 6 
6 1 0 4 2 1 0 6 4 5 0 4 0 1 1 1 5 1 2 0 